11111111111111111111111111111111111111111111111
1E0000001000000000011100000C000000C000000000001
10100101000100000101000000000011001000000010101
10100100101010100111111111110010001000001010101
1P0010000C00C00000000000000011111000000010000C1
1010001111111000100000000000111111C0C1111000011
11000000110000000111111110000000000001000000001
11111111111111111111111111111111111111111111111
